1111111111111111111111111111111111111
10E00P1000000010C00000C00000000000001
1010010100100100101001C00000010100001
1010010010101C10001001000000010100001
100100000C00C000000000001C10000000001
1111111111111111111111111111111111111
