1111111111111111111111111111111111
1E00000000000001C10000000000000001
1010010100100000101001000000010101
1010010010101010001001000000010101
1P000000000000000000000010100X0001
1111111111111111111111111111111111
